1111111
100C0E1
1000P11
1100001
1001001
1010101
110C0C1
1111111