1111111111111
10010000000C1
1000011100011
1P0011ECC1001
1111111111111
