11111111111111111111
1E000000000000000001
10101010101010101001
101C00C00C00C00C0C01
101C00C00C00C00C0C01
101C11C11C11C11C1C01
10101010101010101001
101C00C00C00C00C0C01
10111101101101111101
1P0000000000000000C1
11111111111111111111